00000000000000000000000000000000000000000000000000000000000000000000000000000000000000000000000000000000000000000000000000000000000000000000000000000000000000000000000000000000000000000000000
00000000000000000000000000000000000000000000000000000000000000000000000000000000000000000000000000000000000000000000000000000000000000000000000000000000000000000000000000000000000000000000000
00000000000000000000000000000000000000000000000000000000000000000000000000000000000000000000000000000000000000000000000000000000000000000000000000000000000000000000000000000000000000000000000
00000000000000000000000000000000000000000000000000000000000000000000000000000000000000000000000000000000000000000000000000000000000000000000000000000000000000000000000000000000000000000001111
22210000000000000000000000000000000000000000000000000000000000000000000000000000000000000000000000000000000000000000000000000000000000000000000000000000000000000000000000000000000000000012222
22221000000000000000000000000000011100111111100000000000000000000000000000001111100000000000000000000000000000000000000000111111000000000000000000011111000000000000000000000000000000000122222
22222100000000000000011100011100000000000000011111000000001111000000001110000000000111100011111000000000000000000000000001122221100000000000001111000000000011110000000111100000000000001222222
22222100000000000000000000000000000000000000000000000000012222100000000000000000000000000000000000000000000000000000000011222222110000000000000000000000000000000000001222210000000000001222222
22222100000000000000000000000000000000000000000000000000122222210000000000000000000000000000000000000000001111000000000112222222211000000000000000000000000000000000012222221000000000001222222
11111111111111111111111111111100011111111111111111111111111111111100011111111111111111111111111111111111112222111111111111111111111111111111111111111111111111111111111111111111110001111111111
22222222222222222222222222222220002222222222222222222222222222222200022222222222222222222222222222222222222222222222222222222222222222222222222222222222222222222222222222222222200022222222222
22200000000000000000000000000002000200000000000000000000000000000000000000000000000000000000000000000000000000000000000000000000000000000000000000000000000000000000000000000002000200000000222
22200000000000000000000000000000200000000000000000000000000000000000000000000000000000000000000000000000000000000000000000000000000000000000000000000000000000000000000000000030003000000000222
33300000000000000000000000000000000000000000000000000000000000000000000000000000000000000000000000000000000000000000000000000000000000000000000000000003300000000000000000000000000000000000333
33300000000000000000000000000000000000000000000000000000000000000000000000000033333000000000000000000000003300000000003300000000000000000000000000000033333000000000000000000000000000000000333
33333333333333333333333333333333333333333333333333333000000003333300033333333333333333333333000333333333333333333333333333333333300033333333333333333333333333333333333333333333333333333333333
33300000000000000000000000000000000000000000000000000300000030000000000000000000000000000000300030000000000000000000000000000003000300000000000000000000000000000000000000000000000000000000333
33300000000000000000000000000000000000000000000000000033333300000000000000000000000000000000030003000000000000000000000000000030003000000000000000000000000000000000000000000000000000000000333
33300000000000000000000000000000000000000000000000000000000000000000000000000000000000000000000000000000000000000000000000000000000000000000000000000000000000000000000000000000000000000000333
33300000000000000000000000000000000000000000000000000000000000000000000000000000000000000000000000000000000000000000000000000000000000000000000000000000000000000000000000000000000000000000333
33300000000000000000000000000000000000000000000000000000000000000000000000000000000000000000000333333333330000000000003333333333333000000000000000000000000000000000000000000000000000000000333
33300000000000000000000000000000000000000000000000000000000000000000000000000000000000000000300000000000000000000000000000000000000300000000000000000000000000000000000000000000000000000000333
33300000000000000000000000000000000000000000000000000000000000000000000000000000000033333330000000000000000000000000000000000000000003333333300000000000000000000000000000000000000000000000333
33300000000003333333333333333333333333333333333333333333333330000000000000000000003000000000000000000000000000000000000000000000000000000000003000000000000000000000000000000000000000000000333
33300000000000000000000000000000000000000000000000000000000003300000000000003333300000000000000000000000000000000000000000000000000000000000000003333333333333330000000000000000000000000000333
33300000000000000000000000000000000000000000000000000000000000333300003333000000000000000000000000000000000000000000000000000000000000000000000000000000000000000000000000000000000000000000333
33300000333300000000000000000000000000000000000000000000000000000000000000000000000000000000000000000000000033333330000000000000000000000000000000000000000000000333333000000000000000000000333
33300000000000000000000000000000000000000000000000000000000000000000000000000000000000000000000000000000000000000000000000000000000000000000000000000000000000000000000000333333000000000000333
33300000000000000000000000000000000000000000000000000000000000000000000000000000000000000000000000000000000000000000000000000000000000000000000000000000000000000000000000000000033333000000333
33300000000003333333333333333333000000000000000000000000000000000000000000000000000000000000000000000000000000000000000000000000000000000000000000000000000000000000000000000000000000003000333
33300000000000000000000000000000000000000000000000000000000000000000000000000000000000000000000000000000000000000000000000000000000000000000000000000000000000000000000000000000000000000003333
33300000000000000000000000000000000000000000000000000000000000000000000000000000000000000000000000000000000000000000000000000000000000000000000000000000000000000000000000000000000000000000333
33300000000000000000000000000000000000000000000000000000000000000000000000000000000000000000000000000000000000000000000000000000000000000000000000000000000000000000000000000000000000000300333
33300000000000000000000000000000003333333333333333333000000000000000000000000333333333333300000033333333333333333333333333333333333000003333333333000000000000000000000000000000000000000000333
33300000000000000000000000000000000000000000000000000000000000000000000000000000000000000000000000000000000000000000000000000000000000000000000000000000000000000000000000000000000000000003333
33300000000000000000000000000000000000000000000000000030000000000000000000000000000000000000000000000000000000000000000000000000000000000000000000000000000000000000000000000000000000000000333
33300000000000000000000000000000000000000000000000000033333333330000000000000000000000000003330000000000000000000000000000000000000033300000000000000000000000000000000000000000000000000300333
33300000000000000000000000000000000000000000000000000000000000000000000000000000000000000000000000000000000000000000000000000000000000000000000000000000000000000000000000000000000000000000333
33300000000000000000000000000000000000000000000000000000000000000000000000000000000000000000000000000000000000000000000000000000000000000000000000000000000000000000000000000000000000000003333
33300000000000000000000000000000000000000000000000000000000000000000000000000000000000000000000333333333333333333333333333333333330000000000000000000000000000000000000000000000000000000000333
33300000000000000000000000000000000000000000000000000000000000000000000000000000000000000000000000000000000000000000000000000000000000000000000000000000000000000000000000000000000000000300333
33300000000000000333333333333333333000000000000000000000000000000000000000000000000000000003300000000000000000000000000000000000000033000000000000000000000000000000000000000000000000000000333
33300000000000000000000000000000000000000000000000000000000000000000000000000000000000000000000000000000000000000000000000000000000000000000000000000000000000000000000000000000000000000003333
33333330000000000000000000000000000033333333333330000000000000000000000000000000000000000000000000000000000000000000000000000000000000000000000000000000000000000000000000000000000000000000333
33300000000000000000000000000000000000000000000000000000000000000000000003333300000000000000000000000000000000000000000000000000000000000000000000000000000000000000000000000000000000000000333
33300000333330000000000000000033330000000000000000000000000000000000000033333330000000000000000000000000000000000000000000000000000000000000000000000000000000000000000000000000000000000003333
33330000000000000000000000000000000000000000000000000000000000000000000333333333000000000000000000000000000000000000000000003333000000000000000000000000000000000000000000000000000000000000333
33333000000000000000000000000000000000000000000000000000000000000000003333333333300000000000000000000000000000000000000000033333300000000000000000000000000000000000000000000000000000000333333
33333333333333333333333333333333333333333333333333333333333333333333333333333333333333333333333333333333333333333333333333333333333333333333333333333333333333333333333333333333333333333333333
33333333333333333333333333333333333333333333333333333333333333333333333333333333333333333333333333333333333333333333333333333333333333333333333333333333333333333333333333333333333333333333333
33333333333333333333333333333333333333333333333333333333333333333333333333333333333333333333333333333333333333333333333333333333333333333333333333333333333333333333333333333333333333333333333
33333333333333333333333333333333333333333333333333333333333333333333333333333333333333333333333333333333333333333333333333333333333333333333333333333333333333333333333333333333333333333333333
